11111111111111111111111111111111111111111111
1000000000000000000000000000000000000000E001
10000000000000000000000000000000000000000001
10000000000000000000000000000000000000000001
10000000000C00000000000000000000000000000001
100000000000C0000000000000000000000000000001
1000000000000C000000000000000000000000000001
11111111111111111111111111111111111111111111