1111111111111111111111111111111111111111111111111111111111111111111111111111111111111111111111111111
1000000000000000000000000000100000000000001000000000000000000000000000000001000000000000000000000001
1000000000000000000000000000000000000CCCCCCCCCCCCC00000000000000000000000000000000000000000000000001
10000P11E000000000000000000000000000000000000C111111100000000000000000000000000000000000000000000001
1111111111111111111111111111111111111111111111111111111111111111111111111111111111111111111111111111