1111111111111111
1111111100CE1111
1111111P00111111
1111111111111111